NO ./sprites/colorstone.xpm
SO ./sprites/mossy.xpm
EA ./sprites/redbrick.xpm
WE ./sprites/wood.xpm

C 38,116,155
F 155,144,98

  11111111  1111111111111111
  10000001111000001000000001
  10010000000000001000000001
  1000000111100000100000000111111111
  11111111  100000100010000000000101
            100000100000000100000001
111111111111100011111110000100000001
110000000001000000000000000111111001
1000000100000000000N0000010000001001
100000010000100000000000000000001001
100000110000111100111100000001001001
1000111111111  1001  100000000000001
10001          1001  111111011111111
10001          1001       101
10001111111111110011111111101111111
10001000000000000000001000000000001
10000000000000000000000000000010001
11111111111111111111111111111111111