


NO ./sprites/colorstone.xpm
SO ./sprites/mossy.xpm
EA ./sprites/redbrick.xpm
WE ./sprites/wood.xpm

C 38,116,255
F 155,244,98


        1111111111111111111111111
        1000000000110000000000001
        1011000001110000000000001
        1001000000000000000000001
111111111011000001110000000000001
100000000011000001110111110111111
11110111111111011100000010001
11110111111111011101010010001
11001000110101011100000000001
1001 100000000001100000010001
10001000000000001101010010101
110000011101010111110111000E111
11110111 1110101 101111010001
11111111 1111111 111111111111